#####################
#####################
######.........######
######.........######
######..............#
######....P........G#
#####################
#####################
#####################