#############################################################################
#...............................................................#...........#
#...............................................................#...........#
#...............................................................#...........#
#...............................................................#...........#
#...............................................................#...........#
#...............................................................#...........#
#...............................................................#...........#
#.............................................#.......#.....................#
#......................#..........................#.........................#
#...P............###...#...###............#..............#......#...........#
#........#####...###...#...###...#####.......#....#....#........#........G..#
#############################################################################
