............................
............................
............................
............................
............................
............................
............................
............................
.P........................G.
############################