#####################
#####################
#####################
#####################
#####################
#####################
#####################
#####################
#####################
######.........######
######.P.....G.######
######.........######
#####################
#####################
#####################
#####################
#####################
#####################
#####################
#####################
####################G
