............................
............................
............................
............................
............................
..........................G.
.............###############
..P..........#..............
.............#..............
##############..............