###############################
#.............................#
#.P...............T...........#
############################..#
#.............................#
#.............................#
#..############################
#.............................#
#............................G#
###############################
