#############################################################################
#...............................................................#...........#
#...............................................................#...........#
#...............................................................#...........#
#.............................................#....#........................#
#......................#....................#....#....#.........#...........#
#...P............###...#...###............#....#....#....#......#...........#
#........#####...###...#...###...#####.......#....#....#........#........G..#
#############################################################################
