####################
####################
####################
########    ########
########    ########
######## P  ########
########    ########
####################
####################
####################
